HHHHHHHHHHHHHHHHHHHHHHH
H     H               H
H     H               H
H     H               H
H A   H               H
H                     H
H     HHHHHH    HHH   H
H                     H
H               H   B H
H     H         H     H
H     H     HHHHH     H
H     H     H         H
H     H     H         H
HHHHHHHHHHHHHHHHHHHHHHH